###############################
# .............#..............#
#.############.#.############.#
#.#.........................#.#
#.#.####.######.######.####.#.#
#.#......#...........#........#
#.###.####.#########.####.###.#
#.............................#
####.#.#######.#.#######.#.####
#....#.........#.........#....#
#.#.###.######.#.######.###.#.#
#.#.....#......#......#.....#.#
#.########.###...###.########.#
#..............#..............#
#.#####.######.#.######.#####.#
#..............#..............#
###############################